Column1,Doc0,Doc1,Doc2,Doc3,Doc4,Doc5,Doc6,Doc7,Column2
the,6,2,0,1,1,3,7,5,25
1,0,7,2,0,8,0,0,0,17
of,4,2,0,0,1,0,6,4,17
i,0,1,0,0,13,1,0,0,15
chpt,0,14,0,0,0,0,0,0,14
and,1,4,0,0,2,2,2,1,12
cse,2,2,2,1,0,0,2,3,12
freeman,4,0,0,0,0,0,4,4,12
moor,4,0,0,0,0,0,4,4,12
for,1,0,0,0,8,1,1,0,11
hmwk,0,11,0,0,0,0,0,0,11
spring,4,2,1,0,0,0,1,3,11
j,0,0,0,0,10,0,0,0,10
2017,1,0,0,0,0,0,5,3,9
2018,4,3,1,1,0,0,0,0,9
stem,0,0,0,0,0,9,0,0,9
thi,2,1,0,1,0,1,2,2,9
assign,0,8,0,0,0,0,0,0,8
due,0,8,0,0,0,0,0,0,8
is,1,1,0,1,0,1,2,2,8
site,2,0,0,0,0,2,2,2,8
var,0,0,0,1,3,4,0,0,8
at,2,0,0,0,0,1,2,2,7
distanc,0,2,2,0,3,0,0,0,7
may,1,4,0,0,0,0,1,1,7
to,0,1,0,0,2,4,0,0,7
2,0,5,0,0,1,0,0,0,6
3,0,4,0,0,2,0,0,0,6
are,1,0,0,1,1,1,1,1,6
dr,2,0,0,0,0,0,2,2,6
fall,1,0,0,0,0,0,4,1,6
in,1,1,0,0,1,1,1,1,6
syllabu,2,0,0,0,0,0,2,2,6
0,0,0,0,0,5,0,0,0,5
53377337,1,2,0,1,0,0,1,0,5
content,1,1,0,0,0,1,1,1,5
cours,1,1,0,0,0,0,1,2,5
exam,0,3,2,0,0,0,0,0,5
exampl,0,4,0,0,0,1,0,0,5
inform,1,1,0,1,0,0,1,1,5
len,0,0,0,0,5,0,0,0,5
lens1,0,0,0,0,5,0,0,0,5
lent,0,0,0,0,5,0,0,0,5
web,1,2,0,0,0,0,1,1,5
15,0,4,0,0,0,0,0,0,4
5,0,4,0,0,0,0,0,0,4
7337,1,0,2,0,0,0,0,1,4
8,0,4,0,0,0,0,0,0,4
apr,0,4,0,0,0,0,0,0,4
articl,0,3,0,0,0,0,1,0,4
do,1,0,0,0,0,1,1,1,4
feb,0,4,0,0,0,0,0,0,4
fmoorelylesmuedu,0,0,0,0,0,0,2,2,4
function,0,0,0,0,2,2,0,0,4
mar,0,4,0,0,0,0,0,0,4
porter,0,1,0,0,0,3,0,0,4
project,0,4,0,0,0,0,0,0,4
schedul,0,4,0,0,0,0,0,0,4
smu,1,1,0,0,0,0,1,1,4
univers,1,1,0,0,0,0,1,1,4
wordlist,0,1,0,0,0,3,0,0,4
you,0,0,0,2,0,2,0,0,4
53307330,1,0,0,0,0,0,1,1,3
6,0,3,0,0,0,0,0,0,3
a,0,0,0,2,0,0,1,0,3
administr,1,0,0,0,0,0,1,1,3
be,1,0,0,0,0,0,1,1,3
calendar,1,0,0,0,0,0,1,1,3
caruth,1,0,0,0,0,0,1,1,3
classif,0,2,0,0,0,1,0,0,3
contact,1,0,0,0,0,0,1,1,3
cost,0,0,0,0,3,0,0,0,3
di,0,0,0,0,3,0,0,0,3
document,0,1,0,0,0,2,0,0,3
em,0,0,0,0,0,3,0,0,3
email,1,0,0,0,0,0,1,1,3
here,0,0,0,0,0,2,1,0,3
index,0,3,0,0,0,0,0,0,3
keep,1,0,0,0,0,0,1,1,3
l,1,0,0,0,0,0,1,1,3
latest,1,1,0,0,0,0,1,0,3
levenshtein,0,1,0,0,2,0,0,0,3
look,1,0,0,0,0,0,1,1,3
methodist,1,0,0,0,0,0,1,1,3
necessarili,1,0,0,0,0,0,1,1,3
not,1,0,0,0,0,0,1,1,3
onlin,0,1,0,0,0,2,0,0,3
opinion,1,0,0,0,0,0,1,1,3
or,1,0,0,0,0,0,1,1,3
phd,1,0,0,0,0,0,1,1,3
polici,1,0,0,0,0,0,1,1,3
repres,1,0,0,0,0,0,1,1,3
respons,1,0,0,0,0,0,1,1,3
s,0,0,0,0,1,2,0,0,3
s1,0,0,0,0,3,0,0,0,3
s2,0,0,0,0,3,0,0,0,3
sole,1,0,0,0,0,0,1,1,3
southern,1,0,0,0,0,0,1,1,3
stemmer,0,1,0,0,0,2,0,0,3
string,0,0,0,0,3,0,0,0,3
student,0,1,2,0,0,0,0,0,3
test,0,0,0,0,0,3,0,0,3
userag,0,0,0,3,0,0,0,0,3
who,1,0,0,0,0,0,1,1,3
17,0,2,0,0,0,0,0,0,2
183,0,0,0,0,0,0,1,1,2
19,0,2,0,0,0,0,0,0,2
22,0,2,0,0,0,0,0,0,2
27-Mar,0,2,0,0,0,0,0,0,2
4,0,2,0,0,0,0,0,0,2
5337,1,0,0,0,0,0,0,1,2
activ,0,2,0,0,0,0,0,0,2
algorithm,0,1,0,0,0,1,0,0,2
cat,0,0,0,0,2,0,0,0,2
class,0,2,0,0,0,0,0,0,2
date,0,1,1,0,0,0,0,0,2
demo,0,0,0,0,1,1,0,0,2
dump,0,0,0,0,0,2,0,0,2
fmooresmuedu,2,0,0,0,0,0,0,0,2
gaq,0,0,0,0,0,2,0,0,2
goe,0,0,0,0,0,2,0,0,2
histori,0,0,0,0,0,0,2,0,2
if,0,0,0,1,1,0,0,0,2
ii,0,2,0,0,0,0,0,0,2
it,0,0,0,0,0,2,0,0,2
jan,0,2,0,0,0,0,0,0,2
lens2,0,0,0,0,2,0,0,0,2
levenshteindist,0,0,0,0,2,0,0,0,2
link,0,2,0,0,0,0,0,0,2
locat,0,0,2,0,0,0,0,0,2
mij,0,0,0,0,2,0,0,0,2
model,0,2,0,0,0,0,0,0,2
myformdistancevalu,0,0,0,0,2,0,0,0,2
new,0,0,0,0,2,0,0,0,2
no,0,2,0,0,0,0,0,0,2
output,0,0,0,0,0,2,0,0,2
overlap,0,0,0,0,0,2,0,0,2
overlay,0,0,0,0,0,2,0,0,2
pm,0,0,2,0,0,0,0,0,2
refer,0,0,0,0,0,2,0,0,2
retriev,0,2,0,0,0,0,0,0,2
score,0,2,0,0,0,0,0,0,2
space,0,2,0,0,0,0,0,0,2
strength,0,0,0,0,0,2,0,0,2
t,0,0,0,0,2,0,0,0,2
temptat,0,0,0,0,0,2,0,0,2
that,0,0,0,0,0,2,0,0,2
topic,0,1,0,0,0,1,0,0,2
vector,0,2,0,0,0,0,0,0,2
word,0,0,0,0,0,2,0,0,2
x,0,0,0,2,0,0,0,0,2
yield,0,0,0,0,0,2,0,0,2
8,0,0,0,1,0,0,0,0,1
10-Apr,0,1,0,0,0,0,0,0,1
12,0,1,0,0,0,0,0,0,1
13,0,1,0,0,0,0,0,0,1
13-Feb,0,1,0,0,0,0,0,0,1
13-Mar,0,1,0,0,0,0,0,0,1
14,0,1,0,0,0,0,0,0,1
16,0,1,0,0,0,0,0,0,1
17-Apr,0,1,0,0,0,0,0,0,1
1henk,0,0,1,0,0,0,0,0,1
1-May,0,1,0,0,0,0,0,0,1
20,0,1,0,0,0,0,0,0,1
2016,0,0,0,0,0,0,0,1,1
20958144227,0,0,0,1,0,0,0,0,1
20-Feb,0,1,0,0,0,0,0,0,1
20-Mar,0,1,0,0,0,0,0,0,1
21,0,1,0,0,0,0,0,0,1
23-Jan,0,1,0,0,0,0,0,0,1
24-Apr,0,1,0,0,0,0,0,0,1
25,0,1,0,0,0,0,0,0,1
26,0,1,0,0,0,0,0,0,1
29,0,1,0,0,0,0,0,0,1
2henkel,0,0,1,0,0,0,0,0,1
30feb,0,1,0,0,0,0,0,0,1
317,0,0,1,0,0,0,0,0,1
330450,0,0,0,0,0,0,1,0,1
356,0,0,1,0,0,0,0,0,1
379,1,0,0,0,0,0,0,0,1
3-Apr,0,1,0,0,0,0,0,0,1
3hua,0,0,1,0,0,0,0,0,1
4huang,0,0,1,0,0,0,0,0,1
500,0,0,0,0,0,0,0,1,1
500620,1,0,0,0,0,0,0,0,1
5330,0,0,0,0,0,0,1,0,1
5ma,0,0,1,0,0,0,0,0,1
612,0,1,0,0,0,0,0,0,1
620,0,0,0,0,0,0,0,1,1
6-Feb,0,1,0,0,0,0,0,0,1
6-Mar,0,1,0,0,0,0,0,0,1
6xu,0,0,1,0,0,0,0,0,1
7,0,1,0,0,0,0,0,0,1
7330,0,0,0,0,0,0,1,0,1
7zhou,0,0,1,0,0,0,0,0,1
8zou,0,0,1,0,0,0,0,0,1
9,0,1,0,0,0,0,0,0,1
about,0,0,0,0,0,1,0,0,1
abov,0,0,0,0,0,1,0,0,1
advertis,0,1,0,0,0,0,0,0,1
agent,0,1,0,0,0,0,0,0,1
alejandroproctor,0,0,1,0,0,0,0,0,1
all,0,0,0,0,0,0,0,1,1
alon,0,0,0,0,0,1,0,0,1
an,0,0,0,0,0,0,1,0,1
analysi,0,1,0,0,0,0,0,0,1
array,0,0,0,0,1,0,0,0,1
arraylens1,0,0,0,0,1,0,0,0,1
as,0,1,0,0,0,0,0,0,1
bad,0,1,0,0,0,0,0,0,1
bigram,0,1,0,0,0,0,0,0,1
boolean,0,1,0,0,0,0,0,0,1
break,0,1,0,0,0,0,0,0,1
brief,0,0,0,0,0,0,1,0,1
calcul,0,0,0,0,1,0,0,0,1
canva,0,0,0,0,0,0,0,1,1
carrot2,0,0,0,0,0,1,0,0,1
catch,0,1,0,0,0,0,0,0,1
charact,0,0,0,0,1,0,0,0,1
chrisproctor,0,0,1,0,0,0,0,0,1
cluster,0,1,0,0,0,0,0,0,1
common,0,0,0,0,0,1,0,0,1
complet,0,1,0,0,0,0,0,0,1
compress,0,1,0,0,0,0,0,0,1
costij,0,0,0,0,1,0,0,0,1
courag,0,0,0,0,0,1,0,0,1
crawl,0,1,0,0,0,0,0,0,1
crawler,0,0,0,1,0,0,0,0,1
dark,0,1,0,0,0,0,0,0,1
databas,0,0,0,0,0,0,1,0,1
day,0,1,0,0,0,0,0,0,1
defin,0,0,0,1,0,0,0,0,1
did,0,0,0,1,0,0,0,0,1
diyanginclass382018,0,0,1,0,0,0,0,0,1
docalc,0,0,0,0,1,0,0,0,1
documentcreateelementscript,0,0,0,0,0,1,0,0,1
documentgetelementbyiddemoinnerhtml,0,0,0,1,0,0,0,0,1
documentgetelementbyidoverlapinnerhtml,0,0,0,0,0,1,0,0,1
documentgetelementbyidstemmedinnerhtml,0,0,0,0,0,1,0,0,1
documentgetelementbyidtestvalu,0,0,0,0,0,1,0,0,1
documentgetelementsbytagnamescript0,0,0,0,0,0,1,0,0,1
documentlocationprotocol,0,0,0,0,0,1,0,0,1
dog,0,0,0,0,1,0,0,0,1
els,0,0,0,0,1,0,0,0,1
error,0,1,0,0,0,0,0,0,1
evalu,0,1,0,0,0,0,0,0,1
exam1,0,1,0,0,0,0,0,0,1
example2,0,1,0,0,0,0,0,0,1
examplefast,0,0,0,0,1,0,0,0,1
expans,0,1,0,0,0,0,0,0,1
feedback,0,1,0,0,0,0,0,0,1
field,0,0,0,0,0,1,0,0,1
figur,0,1,0,0,0,0,0,0,1
file,0,0,0,1,0,0,0,0,1
find,0,0,0,0,0,1,0,0,1
fontstylenormaldisplayinlineblockbackground8f8,0,0,0,0,0,1,0,0,1
forix,0,0,0,0,0,1,0,0,1
free,0,0,0,0,0,1,0,0,1
frequenc,0,0,0,0,0,1,0,0,1
ga,0,0,0,0,0,1,0,0,1
gaasync,0,0,0,0,0,1,0,0,1
gaqpushsetaccount,0,0,0,0,0,1,0,0,1
gaqpushtrackpageview,0,0,0,0,0,1,0,0,1
gasrc,0,0,0,0,0,1,0,0,1
gatyp,0,0,0,0,0,1,0,0,1
get,0,0,0,1,0,0,0,0,1
googleanalyticscomgaj,0,0,0,0,0,1,0,0,1
h1margin0fontsize15emmargintop15px,0,0,0,0,0,1,0,0,1
header,0,0,0,1,0,0,0,0,1
heproctor,0,0,1,0,0,0,0,0,1
highlight,0,0,0,0,0,0,1,0,1
hmwk4,0,1,0,0,0,0,0,0,1
http,0,0,0,0,0,1,0,0,1
http11,0,0,0,1,0,0,0,0,1
http9olesporterjsdemohtml,0,0,0,0,0,1,0,0,1
httpaccept,0,0,0,1,0,0,0,0,1
httpclientip,0,0,0,1,0,0,0,0,1
httpsssl,0,0,0,0,0,1,0,0,1
httpwww,0,0,0,0,0,1,0,0,1
implement,0,0,0,0,0,1,0,0,1
inclass,0,0,1,0,0,0,0,0,1
includ,0,0,0,0,0,1,0,0,1
internet,0,1,0,0,0,0,0,0,1
introduct,0,1,0,0,0,0,0,0,1
invers,0,0,0,0,0,1,0,0,1
ir,0,1,0,0,0,0,0,0,1
ix,0,0,0,0,0,1,0,0,1
javascript,0,0,0,0,0,1,0,0,1
js,0,0,0,0,0,1,0,0,1
last,0,0,0,1,0,0,0,0,1
lent1,0,0,0,0,1,0,0,0,1
liangproctor,0,0,1,0,0,0,0,0,1
list,0,1,0,0,0,0,0,0,1
lopez,0,0,1,0,0,0,0,0,1
lucen,0,0,0,0,0,1,0,0,1
m,0,0,0,0,1,0,0,0,1
m0j,0,0,0,0,1,0,0,0,1
maintain,0,1,0,0,0,0,0,0,1
march,0,0,0,1,0,0,0,0,1
mathmin,0,0,0,0,1,0,0,0,1
mengliproctor,0,0,1,0,0,0,0,0,1
mercat,0,1,0,0,0,0,0,0,1
mi,0,0,0,0,1,0,0,0,1
mi0,0,0,0,0,1,0,0,0,1
mi1j,0,0,0,0,1,0,0,0,1
mi1j1,0,0,0,0,1,0,0,0,1
mij1,0,0,0,0,1,0,0,0,1
mlenslent,0,0,0,0,1,0,0,0,1
more,0,0,0,0,0,1,0,0,1
multipl,0,0,0,0,0,1,0,0,1
mw,0,0,0,0,0,0,1,0,1
myformstring1valu,0,0,0,0,1,0,0,0,1
myformstring2valu,0,0,0,0,1,0,0,0,1
name,0,0,0,1,0,0,0,0,1
navigatoruserag,0,0,0,1,0,0,0,0,1
nonword,0,0,0,0,0,1,0,0,1
number,0,0,0,0,1,0,0,0,1
numberpersonlocationrequest,0,0,1,0,0,0,0,0,1
offici,0,0,0,0,0,1,0,0,1
on,0,1,0,0,0,0,0,0,1
oracl,0,0,0,0,0,0,1,0,1
oscar,0,0,0,0,0,1,0,0,1
out,0,0,0,0,0,1,0,0,1
overlapjoin,0,0,0,0,0,1,0,0,1
overlapoverlaystemmedbackgroundefepadding5pxtextalignleft,0,0,0,0,0,1,0,0,1
overlappushwordlistixreplacestem,0,0,0,0,0,1,0,0,1
overview,0,1,0,0,0,0,0,0,1
page,0,1,0,0,0,0,0,0,1
per,0,1,0,0,0,0,0,0,1
permuterm,0,1,0,0,0,0,0,0,1
post,0,1,0,0,0,0,0,0,1
preliminari,0,1,0,0,0,0,0,0,1
proctor,0,0,1,0,0,0,0,0,1
qizhiproctor,0,0,1,0,0,0,0,0,1
queri,0,1,0,0,0,0,0,0,1
read,0,1,0,0,0,0,0,0,1
realli,0,0,0,0,0,1,0,0,1
receiv,0,0,0,1,0,0,0,0,1
relat,0,0,0,0,0,1,0,0,1
relev,0,1,0,0,0,0,0,0,1
requestmethod,0,0,0,1,0,0,0,0,1
requir,0,0,0,0,0,1,0,0,1
respect,0,0,0,0,1,0,0,0,1
return,0,0,0,0,1,0,0,0,1
review,0,1,0,0,0,0,0,0,1
s1length,0,0,0,0,1,0,0,0,1
s2length,0,0,0,0,1,0,0,0,1
scharati1,0,0,0,0,1,0,0,0,1
search,0,1,0,0,0,0,0,0,1
sent,0,0,0,1,0,0,0,0,1
serverprotocol,0,0,0,1,0,0,0,0,1
similar,0,1,0,0,0,0,0,0,1
softwar,0,0,0,0,0,1,0,0,1
soundex,0,1,0,0,0,0,0,0,1
sparentnodeinsertbeforega,0,0,0,0,0,1,0,0,1
spell,0,1,0,0,0,0,0,0,1
split,0,0,0,0,0,1,0,0,1
statu,0,1,0,0,0,0,0,0,1
stemmedjoin,0,0,0,0,0,1,0,0,1
stemmedpushstem,0,0,0,0,0,1,0,0,1
stemmerwordlistix,0,0,0,0,0,1,0,0,1
stop,0,0,0,0,0,1,0,0,1
system,0,0,0,0,0,0,1,0,1
taught,0,0,0,0,0,1,0,0,1
tcharatj1,0,0,0,0,1,0,0,0,1
tell,0,0,0,0,0,1,0,0,1
tent,0,0,0,0,0,0,0,1,1
term,0,1,0,0,0,0,0,0,1
terribl,0,0,0,0,0,1,0,0,1
testreplace\sg,0,0,0,0,0,1,0,0,1
testreplace\wg,0,0,0,0,0,1,0,0,1
testsplit,0,0,0,0,0,1,0,0,1
text,0,1,0,0,0,0,0,0,1
textareaoverlapoverlaystemmedwidth600pxheight300pxoverflowyscrollfontfamilymonospac,0,0,0,0,0,1,0,0,1
textjavascript,0,0,0,0,0,1,0,0,1
there,0,0,0,0,0,1,0,0,1
think,0,0,0,0,0,1,0,0,1
tianqiinclass352018,0,0,1,0,0,0,0,0,1
TRUE,0,0,0,0,0,1,0,0,1
tth,1,0,0,0,0,0,0,0,1
tuesday,0,1,0,0,0,0,0,0,1
tuesdaythursday,0,0,0,0,0,0,0,1,1
ua87596654,0,0,0,0,0,1,0,0,1
uniqu,0,0,0,1,0,0,0,0,1
up,0,1,0,0,0,0,0,0,1
updat,0,0,0,1,0,0,0,0,1
user,0,1,0,0,0,0,0,0,1
vs,0,0,1,0,0,0,0,0,1
weak,0,0,0,0,0,1,0,0,1
which,0,0,0,0,0,1,0,0,1
whitespac,0,0,0,0,0,1,0,0,1
wild,0,0,0,0,0,1,0,0,1
wildcard,0,1,0,0,0,0,0,0,1